11111111111111111111
19001000000000111111
10700000010000000111
11111000010000110111
10000011110050110111
10000000010000110111
10000000010111110111
10000000016000110111
10000000010000110111
11011111111111110111
11011111111111110111
10601000000000110111
10000000010000110111
11011000010500000111
11010011110000111111
1w000000010000000001
10000000010111110001
12300000010000110001
1*400000510000000501
11111111111111111111
