11111111111111111111
190w1000010000111111
10500005010000555111
1111100001000011$111
10000011110050111111
10000000010000111111
10005000010111111111
10000000016000111111
1000000000000$111111
11011111111111111111
11011111111111111111
10501000000000111111
10000050010000111111
11011000$10500000111
11010011110000111111
10000000010000000001
10000000010111110001
1230000001000011$001
1*400000510000000501
11111111111111111111
